111111111111111
1P1000001C10001
100010000000001
111110011000K11
110000010E00111
1000K0001C01001
111111111111111